21 21
XXXXXXXXXXGGGGGGGGGGG
X*        GGGGGGGGGGG
X XX XX XXGGGGGGGGGGG
X XX XX XXGGGGGGGGGGG
X     X   GGGGGGGGGGG
X XX      GGGGGGGGGGG
X XXX  XX GGGGGGGGGGG
X       X GGGGGGGGGGG
X XX XX X 1GGGGGGGGGG
X XX XX XXGGGGGGGGGGG
        X234GGGGGGGGG
X XX XX XXGGGGGGGGGGG
X XX XX X GGGGGGGGGGG
X       X GGGGGGGGGGG
X XXX  XX GGGGGGGGGGG
X XX      GGGGGGGGGGG
X     X   GGGGGGGGGGG
X XX XX XXGGGGGGGGGGG
X XX XX XXGGGGGGGGGGG
X*P       GGGGGGGGGGG
XXXXXXXXXXGGGGGGGGGGG
