7 7
XXXXXXX
X     X
X X-X X
  X1X  
X XXX X
X  P  X
XXXXXXX
