7 7
XXXXXXX
XP    X
X X-X X
  X1X  
X XXX X
X     X
XXXXXXX
